// Labyrinth
#################
#...#...........#
#...#...........#
#...#...........#
#...#####...#####
#...............#
#...............#
#...............#
#####...#####...#
#.......#.......#
#.......#.......#
#.......#.......#
#...#########...#
#...............#
#...............#
#...............#
#################