// testen mit offener wand
#######...#######
#...............#
#...............#
#.......#.......#
#.......#.......#
#..###########..#
#..#.........#..#
#..#.........#..#
#...............#
#...............#
#######...#######