// neue bessere Webots world
######################################################################################
######################################################################################
###########        *##################################################################
##*                .##################################################################
#.                 .##################################################################
#*.                 ##################################################################
##.                 ##################################################################
##.                .##################################################################
##*                 ##################################################################
##*                 ##################################################################
##.                 *#################################################################
##.                 .#################################################################
##*                 .#################################################################
###                 .#################################################################
###.                .#################################################################
###*                .#################################################################
####                .#################################################################
####                 #################################################################
####                 #################################################################
####                ..################################################################
####                 *################################################################
####                 .################################################################
####.                .################################################################
####*                .################################################################
#####                .################################################################
#####                .################################################################
#####                 ################################################################
#####                *################################################################
#####                 ###################################################*.*##########
#####                 #############################################****.*.* ##########
#####*                ####################################***###**.*.       ##########
######                ##############################*#######*.              ##########
######                #######################**#######                      *#########
######                ################**#######.                             #########
######                .###############*.                                     #########
######                 ###*####*                                             #########
######                 .                                                     #########
######                                                                       #########
######.                                                                      #########
#######                                                                      *########
#######                                                                       ########
#######                                                                       ########
#######                                                                       ########
#######                                                                       ########
#######                                                                       ########
#######                                                                       ########
#######*                                                                      *#######
########                                                                       #######
########                                                   ...                 #######
########                                           .....*..*##                 #######
########                                    . **.***######***#                 #######
########                             #.....#*#################                 #######
########                     #################################                 #######
########               ***########*###########################*                #######
########        *###### #**###################################*                #######
#########*#######*############################################*                #######
#########*####################################################*                *######
##############################################################*                 ######
##############################################################*                 ######
##############################################################*                 ######
###############################################################.                ######
###############################################################.                ######
###############################################################.                *#####
###############################################################.                *#####
###############################################################.                .#####
###############################################################.                 #####
###############################################################*                 #####
################################################################                 #####
################################################################.                #####
################################################################                 .####
################################################################                 .####
################################################################                 ..###
################################################################                  *###
################################################################                  *###
################################################################*                 *###
#################################################################                 *###
#################################################################                 *###
#################################################################                  ###
#################################################################.                 *##
#################################################################.                  ##
#################################################################.                 *##
#################################################################*                 *##
#################################################################*                *###
##################################################################.       .###########
##################################################################.*##################
######################################################################################
######################################################################################
