// SkullWorld
##########
###....###
#........#
#.#...#..#
#...#....#
##......##
##########