######################
#....................#
#....................#
#....................#
#....############....#
#....############....#
#....############....#
#.............###....#
#.............###....#
#.............###....#
#....############....#
#....############....#
#....############....#
#....###.............#
#....###.............#
#....###.............#
#....############....#
#....############....#
#....############....#
#....................#
#....................#
#....................#
######################
